0000000000000000000000  
0 0 0 0 00 0 0 0 0 0 0  
00 0 0 00 0 0 0 0 0 00  
0 0 0 0 00 0 0 0 0 0 0  
00 0 0 00 0 0 0 0 0 00  
0 0 000000000000 0 0 0  
00 0 0     03 300 0 00  
0 0 00 000 0   0 0 0 0  
00 0 01    2   00 0 00  
0 0 00     2   0 0 0 0  
00 0 0 000 0   00 0 00  
0 0 00     00 00 0 0 0  
00 0 000000000000 0 00  
0 0 0 0 00 0 0 0 0 0 0  
00 0 0 00 0 0 0 0 0 00  
0 0 0 0 00 0 0 0 0 0 0  
00 0 0 00 0 0 0 0 0 00  
0 0 0 0 00 0 0 0 0 0 0  
00 0 0 00 0 0 0 0 0 00  
0 0 0 0 00 0 0 0 0 0 0  
00 0 0 00 0 0 0 0 0 00  
0000000000000000000000  
                        
                        
